.....#...#.....#................#
####.###.........................
##.....##..#.#......#######.....#
#...#......#.........######.#####
..#..#.....##..#............#...#
####.###..........####......#.#..
##.....#...###............###.#.#
#...#......#......##.########.#..
...........##..#...#........###.#
#.##.###.#######.....##.....#.#..
#..#...#...#.............#..#.#.#
#.#.#......#.........###.##.#.#..
.......#...##..#.....######.#.#.#
##.#.###.........#.#..........#..
##.....#...#.....#.############.#
#..###.....#...#.................
